#############
#...........#
#...........#
#...........#
#...........#
#...........#
#..#######..#
#..#.#.#.#..#
#..#...#.#..#
#.S#.#.#.#G.#
#....#...#..#
#..#.#.#....#
#############