#############
#...........#
#......####.#
#......#..#.#
#......#G...#
#......#..#.#
#......####.#
#...........#
#...........#
#...........#
#.S.........#
#...........#
#############