#############
#...........#
#.S.........#
#...........#
#...........#
#...........#
#...........#
#...........#
#...........#
#...........#
#.........G.#
#...........#
#############