#############
#......#....#
#.S....#....#
#...........#
#......#....#
#......#....#
###.######.##
#.....#.....#
#.#.#.#.....#
#.....#.....#
#.#.#.....G.#
#.....#.....#
#############