##################
##################
##S....#........##
##.....#........##
##..####..####..##
##..#..#..#.....##
##..#..#..#.....##
##..#..#..########
##..............##
##..............##
##..#####..#######
##.....#........##
##.....#........##
########..########
##..............##
##.............G##
##################
##################