#########################
#.......#.......#.......#
#.S.....#.......#.......#
#.......#.......#.......#
#.......................#
#.......#.......#.......#
#.......#.......#.......#
#.......#.......#.......#
####.#######.#######.####
#.......#.......#.......#
#.......#.......#.......#
#.......#.......#.......#
#.......................#
#.......#.......#.......#
#.......#.......#.......#
#.......#.......#.......#
####.#######.#######.####
#.......#.......#.......#
#.......#.......#.......#
#.......#.......#.......#
#.......................#
#.......#.......#.......#
#.......#.......#.....G.#
#.......#.......#.......#
#########################