###############################
#.............#...#....#......#
#.S...........#...#....#...#..#
#.............#........#...#..#
#.............#...#....#......#
#.............#...#....#...#..#
#.............#........#...#..#
#.............#...#........#..#
#.............#####....##.##..#
#.............#...#....#...#..#
#.............#...#....#...#..#
#.............#...#....#......#
#.............#...#....#...#..#
#.............#...#....#...#..#
#.................#....#......#
#.............#...######...#..#
################.##....##.##..#
#.............#...#....#...#..#
#.................#....#...#..#
#.............#...#....#...#..#
###.#########.#####....#......#
#....#..........#......#...#..#
#....#..........####.###...#..#
#....#..........#......##.##..#
#......................#...#..#
#....#..........#...........G.#
#....#..........#......#...#..#
###############################
