###############################
#.........#.........#.........#
#.S.......#.........#.........#
#.........#.........#.........#
#.........#.........#.........#
#.........#.........#.........#
#.............................#
#.........#.........#.........#
#.........#.........#.........#
#.........#.........#.........#
#.........#.........#.........#
#.........#.........#.........#
#####.#########.#########.#####
#.........#.........#.........#
#.........#.........#.........#
#.........#.........#.........#
#.........#.........#.........#
#.........#.........#.........#
#.............................#
#.........#.........#.........#
#.........#.........#.........#
#.........#.........#.........#
#.........#.........#.......G.#
#.........#.........#.........#
###############################
