#############
#...#...#...#
#...#...#...#
##.###.###.##
#...........#
#...........#
#...........#
#...........#
#...........#
#...........#
#.S.......G.#
#...........#
#############