##################
##################
##..............##
##...#######....##
##..#.......#...##
##...........#..##
##....####...#..##
##...#....#..#..##
##..#..##.#..#..##
##..#.#G..#..#..##
##..#.#...#..#..##
##..#..###...#..##
##..#........#..##
##...#......#...##
##....######....##
##.............S##
##################
##################