#####################
#.........#.........#
#.S.......#.........#
#.........#.........#
#.........#.........#
#.........#.........#
#...................#
#.........#.........#
#.........#.........#
#.........#.........#
#.........#.......G.#
#.........#.........#
#####################