#############
#......#....#
#.S....#....#
#...........#
#......#....#
#......#....#
###.######.##
#.....#.....#
#.....#.....#
#...........#
#.....#...G.#
#.....#.....#
#############